EA textures/wallpaper4.png
R    1500    900

NO textures/wallpaper1.png
SO textures/wallpaper2.png

F 69,  39,99


WE       textures/wallpaper3.png
C     50, 50, 0

S    textures/sprite.png

        1111111111111111111111111
        1000000000110000000000001
        1011000001110000002000001
        1001000000000000000000001
111111111011000001110000000000001
100000000011000001110111111111111
11110111111111011100000010221
11110111111111011101010010001
11000000110101011120000210001
10002000000000001100000010001
100000020000000E1101010000001
1100000111010101111101111000111
11110111 1110101 101111010001
11111111 1111111 111111111111
