R 1600 800
NO textures/wallpaper1.png
SO textures/wallpaper2.png
WE textures/wallpaper3.png
EA textures/wallpaper4.png
S textures/sprite.png
F 184,113,39
C 51,198,227

1111011111111111111111111
11110111111111010101010011111
110000001101010111000000120001
100020000000000011000000100001
100000000000000011010100000001
1100000111010101111101111000111
11110111 1110101 10111101000N1
11111111 1111111 111111111111