S pics/barrel.png
NO pics/wallpaper2.png
SO pics/wallpaper1.png
EA pics/wallpaper3.png
C 0,0,200
WE pics/wallpaper4.png
F 0,0,0
R 1000 1000

11111111111111111111111111111
11110110000111000100000010001
11110110000111011100002010001
11000000110100010000000010001
1000020000000000200N000000001
10020000000020000000010100101
11000001110100011111011110011
11110110001101010001111010001
11111111111111111111111111111